####################
#        ##        #
# ###### ## ###### #
#                  #
# ###### ## ###### #
#        ##        #
####################